%%%%%%%
%ffGff%
%ooooo%
%foPof%
%%%%%%%