%%%%%%%%
%P ..  %
%.% %%G%
%.% %..%
%G%   o%
%%%%%%%%
