%%%%%%%%%%
%o  P...G%
%%%%%%%%%%
