%%%%%%%
%P ..G%
%..  o% 
%%%%%%%
